NO textures/pngwing.xpm
EA textures/pngwing.xpm
WE textures/pngwing.xpm
SO textures/pngwing.xpm

F 224,172,105
C 205,249,255

		1111111111111111111111111
		1000000000110000000000001
		1011000001110000000000001
		1001000000000000000000001
1111111110110000011100000000000E1
100000000011000001110111111111111
11110111111111011100000010001
11110111111111000001010010001
11000000110101011100000000001
100000000000000011000000100011111111111111111111
100000000000000011010100100000000000000000000001
110000011101010111110111100011111111111111110001111111
1111011111110101110111101001				1000000001
1111111111111111111111111111				1111111111