F                112,109,102
    NO ./texture/1.xpm
    EA ./texture/4.xpm




SO ./texture/2.xpm

WE ./texture/3.xpm
C 184,224,223
        1111111111111111111111111
        1000000000110000000000001
        1011000001110000000000001
        1001000000000000000000001
111111111011000001110000000000001
100000000011000001110111111111111
111101111111110111000000100011111111
111101111111110111010100100000000001
11000000110101011100000010001111111
10000000000000001100000010001
10000000000000001101010010001
1100000111010101111101111000111
11110111 1110101 101111010001
11111111 1111111 111111111111